111111
100101
111111
1100N1
111111